





NO fdfsdfsdf

SO       gdgd     
F   0,0,0


C 255,255,255
EA asaasdasda
WE END

        
1111111
1000001
1000011
10N0001
1000101
1111111