





NO fdfsdfsdf

SO       gdgd     
F   0,255,0


C 255,255,255
EA asaasdasda
WE END

        
1111111
1000001
1011001
1000N01
1010001
1111111