





NO fdfsdfsdf

SO       gdgd     
F   0,255,0


C 255,255,255
EA asaasdasda
WE END

        
111111111
100000001
101100001
1000N0001
101000001
100000001
100000001
111111111