





NO fdfsdfsdf

SO gdgd     
F 20,20,14


C 240,250,250
EA asaasdasda
WE END

        
1111111
1     000001
10N00001
1000001
1000001
       
1111111