NO ./img/greystone.xpm
EA ./img/redbrick.xpm
WE ./img/bluestone.xpm
SO       ./img/mossy.xpm  

F 220,100,0
C 225,30,0

        11111111111111111111111111111111111111111111111111111111111111111
        10000000000000000000000000000000000000000000000000000000000000001
        10000000001100000000000011111111111111100000000000000000001111111
        1011000001110000000000001             100000000000111111111000111
        1001000000000000000000001     11111111111110000000000000000001111111
11111111101100000111000000000000111111100000000011100000001111000000000001
10000000001100000111011111111111100000000000000000000000000000000000000001
11110111111111011100000010001000000000000000000000000000000000000000000001
11110111111111011101010010001000000000000000000111111000000000000000000001
110000001101010111000000100010000000111110000001   11000000000000000000001
10000000000000001100000010001000000010001000000111111000000000000000000001
1000000000000000110101000000100000001111100000000000000000000000000000000111
11000001110101011111010000N0111000000000000000000000000000000000000000000001
11110111 1110101 10111101000100000000000000000000000000000000000000000000111
11111111 1111111 111111111111111111111111111111110000111111111111111110001
11111111111111111111111111111111111111111111111110000111111111111111111111
                                           100000000000000001
                                           100000000000000001
                                           100000000000000001
                                           100000000000000001
                                           100000000000000001
                  1111111111111111111111111100000000000000011111111111
                  1000100000001111100000000000000000000000000000000111
                  1000100000001111100000000000000000000000000000000111
                  1000100000001111100000000000000000000000000000000111
                  100000000000000000000000000000000000000000000000001
                  111111111111111111111111111111111111111111111111111