NO ./Cub3D/textures/normi1.xpm
EA ./Cub3D/textures/normi2.xpm
WE ./Cub3D/textures/normi3.xpm
SO       ./Cub3D/textures/normichiotte.xpm
F 166,159,141
C 84,71,56

11111111111
10000000111
100S00111
10000000111
10010010001
11110000101
   11111111