NO ./img/greystone.xpm
EA ./img/redbrick.xpm
WE ./img/bluestone.xpm
SO       ./img/mossy.xpm  

F 30,30,30
C 30,30,30

111111
100001
100N01
100101
111111