NO ./img/greystone.xpm
EA ./img/redbrick.xpm
WE ./img/bluestone.xpm
SO       ./img/mossy.xpm   
F   0,255,0


C 0,0,255

111111111
100000001
101100001
100001001
101000001
100000001
1N1111111
11
111111111
100000001
111111111