NO ./img/greystone.xpm
EA ./img/redbrick.xpm
WE                          ./img/bluestone.xpm
SO       ./img/mossy.xpm   
F   0,255,125


C 54,110,5     

111111111
100000001
101100001
100001001111
101000001  1                   111111111
100000001111                   100000E01
111111111111                   111011111
101111111                         1
101111111
100000001
111111111