





NO ./img/greystone.xpm
EA ./img/redbrick.xpm
WE ./img/bluestone.xpm
SO       ./img/mossy.xpm   
F   0,255,0


C 255,255,255

        
111111111
100000001
101100001
100000001
101000N01
100000001
111111111

111111111
100000001
111111111